
SO textures/s_tex.xpm
NO textures/n_tex.xpm
WE textures/w_tex.xpm
EA textures/e_tex.xpm

C 4, 26, 50
F 45,45,45

111111111111111111111111111111111
100000000000000000000000000000001
100000000000000000000000000000001
100000000000000000000000000000001
111111111011000001110000000000001
100000000011000001110000000000011
111100000000000111000000100010011
111101111110000000010100100010011
110000000000000000000000100010111
100000000000000000000E00100010011
100000000000000011010100100000011
110000011101010111110111000101111
11110111 1110101 1011110100010011
111111111111111111111111111111111