SO textures/s_tex.xpm
NO textures/n_tex.xpm
WE textures/w_tex.xpm
EA textures/e_tex.xpm

C 4, 26, 50
F 45,45,45

111111111111111111111111111111111
100000000000000000000000000000001
100000000000000000000000000000001
100000000000000000000000000000001
111111111011000001110000000000001
100000000011000001110000000000011
1111000000D00001D1000000100010011
111101111110000000010100100010011
110000000000000000000000D00010111
100000000000000000000E00100010011
10000000000000001101D100100000011
110000011101010000000111000101111
11110111 111010101011110100010011
111111111111111111111111111111111