SO textures/south.xpm
NO textures/north.xpm
WE textures/west.xpm
EA textures/east.xpm

C 30, 39, 46
F 87, 96, 111

                   11111111111111111111111111111                 1 
     11111111111111000000000001000000000000000011111111111111111111111111111111111111111111111
11111111111000000000000000000010000000000000000000000000000000000000000000000000000000111111  
100000000000000S00000000000000D0000000000000000000000000000000000000001111111111111110000011111
11111111111000000000000000000010000000000000000000000111111111111111011             10000000001
        111110000000100000000000000000000000000000000111111111111111011             10000000001
    111110000000000000000000000000000000000000000000011111111111111101              10000000001
         11111000000111110000000000000111111111111111              101111111111111111011111111
         111110000111   111000000000000000000000000001             100000000000000000011111   
          11111D11         100000000000000000000000001             1001111111111111111111111  
          11100000111   1110000000000000000000000000111111111111111101111                     
          111000000001111111111111100000000000000000000000000000000001111                     
          11111110000000000000000000000000000000000111111111111110111111                 
1111          1111110000000000000000010000000000000000001    100000001                           
1011          111100000000000000000001000000000000111111    1000000001111111111                  
11          1111110000000000000000000100000000000000001      10000000000000011
                11111111111111111111D11111111111111111111     1111111111000001
           111110000000000000000000000000000000000000001111111      100000001
          11110000000000000000000000000000000000000001111111        10000001
              111110000000000000000000000000000000000000001111111111111111001111
               11110000000000000000000000000000000000000000000000000000001111
                   1111111111111111111101111111111111110111111111111111111111111
                                     11011            101
                                      10001           1001
                                       1101           101
                                 111111110111111111111001
                             1111111110000000111111111001
                             110000000000000000000000001
           11111              11111111111000000000000001
          100000111111111111111000000000000000000000001
          100000000000000000000011000000000001111111111
          11111111111111111000000000000000000000001
                           11111111111111111111111111111111111111