SO textures/south_texture.xpm
NO textures/north_texture.xpm
WE textures/west_texture.xpm
EA textures/east_texture.xpm

C 199, 236, 238
F 0,0,0

         1111111111111111
        
     111111111111111111111111
     1000000000010000000000001
     111011D110000111111111111
     100100000S0000000D000000111111111
     111111111011000001110000000000001
     100000000011000001110111111111111
     1111D111111111011100000010001
     11110111111111011101010010001
     11000000110101011100000010001
     10000000000000001100000010001
     10000000000000001101010010001
     1100000111010101111101111000111
     11110111 1110101 101111010001
     11111111111111111111111111111